################################################
#.......#...........#..........................#
#.......|...........#..........................#
#.......#...........#..........................#
#.$...?.#...........#..........................#
#############K#######..........................#
#...................#..........................#
#...................#..........................#
#...................#..........................#
#...................#..........................#
#...................#..........................#
#...................|..........................#
#...................#..........................#
#...............?...#..........................#
#...................#..........................#
################################################
