################################################
#...........#######$....^^^^...................#
#...........#######.....^^^^...............$...#
#..........######........^^^^...........########
#..........####...........^^^^.........#########
#.......######.............^^^^.........########
#......$#####................^^^^.........######
#....#########...............^^^^...........####
#...#########.................^^^^.............#
#..#########..................^^^^.............#
#..M.######..................^^^^........##....#
###....###...................^^^^.......###....#
####.$......................?IIII.......####...#
#####.......#####............^^^^......######..#
#######....#######............^^^^.....######..#
################################################
