################################################
#¥......#...........#..........................>
#.......|.......î...#..........................#
#.......#...........#..........................#
#.$...?.#..........Ô#..........................#
#############K#######..........................#
#...................#..........................#
#...................#..........................#
#...................#..........................#
#...................#..........................#
#...................#..........................#
#...................|..........................#
#...................#..........................#
#...............?...#..........................#
#...................#..........................#
################################################
