################################################
<.........#..........................#.........#
#.........#..........................#.........|
#.........#...####............####...#.........#
#.........#####..................#####.........#
#..............................................#
#..............................................#
#..............................................#
#..............................................#
#..............................................#
#..............................................#
#..............................................#
#..............................................#
#..............................................#
################################################