################################################
#.......#...........#..........................#
#.......|...........#..........................#
#.......#...........#..........................#
#.o...?.#...........#..........................#
#########...........#..........................#
#...................#..........................#
#...................#..........................#
#...................#..........................#
#...................#..........................#
#...................#..........................#
#...................|..........................#
#...................#..........................#
#...............?...#..........................#
#...................#..........................#
################################################
