################################################
#........# ¶  ¶  '#31D115' ¶¶     ¶¶ #.........#
#######..#   ¶                 ¶  ¶  #.........|
# ¶  ¶#..###########          ¶      #.........#
#  ¶  #...........## ¶          ¶ ¶  ####....###
#######...........##  ¶   ¶    ¶  ¶     #......#
#.....##########..##     ¶      ¶ ¶    ¶#......#
#.................## ¶               ¶  #......#
#..#########..###########################......#
#..# ¶¶  #......#..............#     ¶  #......#
#..#    ¶#......#...###..###...#  ¶   ¶ #......#
#..#  ¶  #......#...#......#...#    ¶   #......#
#..##############...#......#...##########......#
#...................#......#...................#
################################################