################################################
<.........##..........##...........##..........#
#.........##.....+....##...........##..........|
#.........##..........##...........##..........#
#.........\#..........##...........##........###
#..................................##........###
#..................................##..........#
#........./#..........##...........##..........#
#.........##########################/..........#
#.........##.....................##............#
#.........##...../#............+.##............#
#.........\#.....##.....##########/............#
#................##............................#
#................##............................#
################################################